1111111111111
100100C0000C1
1C00C11111001
1P0011E000001
1111111111111