100100C0000C1
1C00011111011
1P0011E0000111
1111111111111